SET ThousandSep=',';
SET DecimalSep='.';
SET MoneyThousandSep=',';
SET MoneyDecimalSep='.';
SET MoneyFormat='$#,##0.00;($#,##0.00)';
SET TimeFormat='h:mm:ss TT';
SET DateFormat='M/D/YYYY';
SET TimestampFormat='M/D/YYYY h:mm:ss[.fff] TT';
SET FirstWeekDay=6;
SET BrokenWeeks=1;
SET ReferenceDay=0;
SET FirstMonthOfYear=1;
SET CollationLocale='en-US';
//SET CreateSearchIndexOnReload=1;
SET MonthNames='Jan;Feb;Mar;Apr;May;Jun;Jul;Aug;Sep;Oct;Nov;Dec';
SET LongMonthNames='January;February;March;April;May;June;July;August;September;October;November;December';
SET DayNames='Mon;Tue;Wed;Thu;Fri;Sat;Sun';
SET LongDayNames='Monday;Tuesday;Wednesday;Thursday;Friday;Saturday;Sunday';

/********************
Connection Variables
Please Update As Needed
*********************/

LIB CONNECT TO $(vConnection);

SET vConnection = 'SPData_Beta';
SET vQVDType = 'Extract';
LET vQVDTypePrefix = left(vQVDType, 1);
LET vFilenamePrefix = vQVDTypePrefix & '_' & upper(vDBname);
SET vQVDTransformType = 'Transform';
SET vStoreConnection = 'SPData_Beta';
SET vQVDStoreType = 'Security';
LET vStoreQVDTypePrefix = left(vQVDStoreType, 1);

LET vNumDateSet = num('2015-01-01');

LET vEntryExitDate = ('2015-01-01');

LET vCallRecordDate = ('2015-01-01');




